                                                                                                             .#%(****%##                                       
                                                                                                         ,  %**********(                                       
                                                                                                      #*****************                                       
          ,,...                                                                                     ,*(*****************%                                      
         (**********************************************/(/(((#%%#%%%%##((//*,,..                 #********************%*%                                     
        .*****************************************************************************************************************(/  (*(                              
        #*****************************************************************************************************************(******%                             
       (**********************************************************************************************************************//                               
       /******************************************************************************************************************%(# ,                                
      %*************************************************************************************************************((#                                        
     ,****************************************************************************************************************/.                                       
     (************************************************************************************************************#(%                                          
    #***********************************************************************************************************((/(                                           
    ************************************************************************************************************(                                              
   %***********************************************************************************************************((*.                                            
  /**********************************************************************************************************%%%*(#/(                                          
  /************************************************************************************************************(###/%*((%                                      
 %****************************************************************************************************************/*******#.                                   
.***************************************************************************************************************************,                                  
#***************************************************************************************************************************(                                  
******************************************************************************************************************************.                                
*******************************************************************************************************************************%                 ###%/.,.      
%%%%%%%%#%#((((//*************************************************************************************************************(#                 %*#,#/**/     
                              **#                                          %##%%%%%##((///*,,,******************************%/,%*(                 .   #**(    
                                                                                              ********************************                        ****.  
                                                                                              *************************************%                   (*****  
                                                                                             .*#*************************************                   *.%**( 
                                                                                                ************************************%                      ***/
                                                                                               #***********************************(                       (*%/
                                                                                                #********/(**************************%                  ,%*****
                                                                                                   %*************************************##/*,.  #(**********&(
                                                                                                    .#/(********************,*/%*************//*************/#%
                                                                                                      %/******************%(  %#**************************//**/
                                                                                                        .**********/****##    (**********#**(*(/*(#         %% 
                                                                                                        ,*********%/.*/%      #*********/,.                **  
                                                                                                         (*********           (**/****#                    (%  
                                                                                                         %*#&***%%         *%#*,                               
                                                                                                             (          #/*%.   %%%*                           
                                                                                                                   ./#*%#.  ,#*****(.                          
                                                                                                                 #(        %********% (*                       
                                                                                                                         ,**************                 ***   
                                                                                                                      %**#*#%#/*.  .,,       #**         ##*,  
                                                                                                                        (%                     %*#%#%##%(/***/ 
                                                                                                                      %/.                         ((*********# 
